4 5 4 5 4 5 4 5 4 5 4 5 4 5 4 5 4 5 4 5 4 5 4 5 4 5 4 5 4 5 4 5 4 5 4 5 4 5 4 5 4 5 4 5 4 5 4 5 4 5 4 5 4 5 4 5 4 5 4 5 4 5 4 5 4 5 4 5 4 5 4 5 4 5 4 5 4 5 4 5 4 5 4 5 4 5 4 5 4 5 4 5 4 5 4 5 4 5 4 5 
4 5 4 5 4 5 4 5 4 5 4 5 4 5 4 5 4 5 4 5 4 5 4 5 4 5 4 5 4 5 4 5 4 5 4 5 4 5 4 5 4 5 4 5 4 5 4 5 4 5 4 5 4 5 4 5 4 5 4 5 4 5 4 5 4 5 4 5 4 5 4 5 4 5 4 5 4 5 4 5 4 5 4 5 4 5 4 5 4 5 4 5 4 5 4 5 4 5 4 5 
4 5 4 5 4 5 4 5 4 5 4 5 4 5 4 5 4 5 4 5 4 5 4 5 4 5 4 5 4 5 4 5 4 5 4 5 4 5 4 5 4 5 4 5 4 5 4 5 4 5 4 5 4 5 4 5 4 5 4 5 4 5 4 5 4 5 4 5 4 5 4 5 4 5 4 5 4 5 4 5 4 5 4 5 4 5 4 5 4 5 4 5 4 5 4 5 4 5 4 5 
4 5 4 5 4 5 4 5 4 5 4 5 4 5 4 5 4 5 4 5 4 5 4 5 4 5 4 5 4 5 4 5 4 5 4 5 4 5 4 5 4 5 4 5 4 5 4 5 4 5 4 5 4 5 4 5 4 5 4 5 4 5 4 5 4 5 4 5 4 5 4 5 4 5 4 5 4 5 4 5 4 5 4 5 4 5 4 5 4 5 4 5 4 5 4 5 4 5 4 5 
4 5 4 5 4 5 4 5 4 5 4 5 4 5 4 5 4 5 4 5 4 5 4 5 4 5 4 5 4 5 4 5 4 5 4 5 4 5 4 5 4 5 4 5 4 5 4 5 4 5 4 5 4 5 4 5 4 5 4 5 4 5 4 5 4 5 4 5 4 5 4 5 4 5 4 5 4 5 4 5 4 5 4 5 4 5 4 5 4 5 4 5 4 5 4 5 4 5 4 5 
4 5 4 5 4 5 4 5 4 5 4 5 4 5 4 5 4 5 4 5 4 5 4 5 4 5 4 5 4 5 4 5 4 5 4 5 4 5 4 5 4 5 4 5 4 5 4 5 4 5 4 5 4 5 4 5 4 5 4 5 4 5 4 5 4 5 4 5 4 5 4 5 4 5 4 5 4 5 4 5 4 5 4 5 4 5 4 5 4 5 4 5 4 5 4 5 4 5 4 5 
4 5 4 5 4 5 4 5 4 5 4 5 4 5 4 5 4 5 4 5 4 5 4 5 4 5 4 5 4 5 4 5 4 5 4 5 4 5 4 5 4 5 4 5 4 5 4 5 4 5 4 5 4 5 4 5 4 5 4 5 4 5 4 5 4 5 4 5 4 5 4 5 4 5 4 5 4 5 4 5 4 5 4 5 4 5 4 5 4 5 4 5 4 5 4 5 4 5 4 5 
4 5 4 5 4 5 4 5 4 5 4 5 4 5 4 5 4 5 4 5 4 5 4 5 4 5 4 5 4 5 4 5 4 5 4 5 4 5 4 5 4 5 4 5 4 5 4 5 4 5 4 5 4 5 4 5 4 5 4 5 4 5 4 5 4 5 4 5 4 5 4 5 4 5 4 5 4 5 4 5 4 5 4 5 4 5 4 5 4 5 4 5 4 5 4 5 4 5 4 5 
4 5 4 5 4 5 4 5 4 5 4 5 4 5 4 5 4 5 4 5 4 5 4 5 4 5 4 5 4 5 4 5 4 5 4 5 4 5 4 5 4 5 4 5 4 5 4 5 4 5 4 5 4 5 4 5 4 5 4 5 4 5 4 5 4 5 4 5 4 5 4 5 4 5 4 5 4 5 4 5 4 5 4 5 4 5 4 5 4 5 4 5 4 5 4 5 4 5 4 5 
4 5 4 5 4 5 4 5 4 5 4 5 4 5 4 5 4 5 4 5 4 5 4 5 4 5 4 5 4 5 4 5 4 5 4 5 4 5 4 5 4 5 4 5 4 5 4 5 4 5 4 5 4 5 4 5 4 5 4 5 4 5 4 5 4 5 4 5 4 5 4 5 4 5 4 5 4 5 4 5 4 5 4 5 4 5 4 5 4 5 4 5 4 5 4 5 4 5 4 5 
4 5 4 5 4 5 4 5 4 5 32 32 32 32 32 32 32 32 32 32 32 32 32 32 32 32 32 32 32 32 32 32 32 32 32 32 32 32 32 32 32 32 32 32 32 32 32 32 32 32 32 32 32 5 4 5 4 5 4 5 4 32 32 32 32 32 32 32 32 32 32 32 32 32 32 32 32 32 32 32 32 32 32 32 32 32 32 32 32 32 4 5 4 5 4 5 4 5 4 5 
4 5 4 5 4 5 4 5 4 5 32 2 2 12 2 2 2 2 2 12 2 2 2 2 2 2 2 2 2 2 2 2 2 11 2 2 2 2 2 2 2 2 2 2 2 2 2 11 2 2 2 2 2 17 4 5 4 5 4 5 4 22 3 3 3 3 3 3 3 2 2 2 2 2 2 2 2 2 2 2 2 2 2 2 2 2 2 2 2 32 4 5 4 5 4 5 4 5 4 5 
4 5 4 5 4 5 4 5 4 5 32 2 2 2 2 2 12 2 2 2 2 2 12 2 2 2 2 2 2 2 2 11 2 2 2 2 12 2 2 2 11 2 2 2 2 2 2 2 2 2 2 2 2 24 4 5 4 5 4 5 4 22 3 18 19 18 19 19 1 1 1 21 2 2 2 2 20 21 2 2 2 2 2 2 2 2 2 20 21 32 4 5 4 5 4 5 4 5 4 5 
4 5 4 5 4 5 4 5 4 5 32 2 2 20 1 1 1 1 1 1 1 1 1 1 1 1 21 2 23 2 20 1 1 1 1 1 1 1 1 1 1 1 2 12 2 2 2 2 20 1 1 21 2 24 4 5 4 5 4 5 4 22 3 25 26 25 26 26 3 1 1 13 2 2 2 2 27 28 2 2 2 23 2 2 2 2 2 6 13 32 4 5 4 5 4 5 4 5 4 5 
4 5 4 5 4 5 4 5 4 5 32 2 2 27 1 1 1 1 1 1 1 1 1 1 1 1 1 23 2 23 27 1 1 1 1 1 1 1 1 1 1 1 2 2 2 2 12 2 1 1 1 28 2 24 4 5 4 5 4 5 4 22 3 18 19 18 19 19 3 27 1 13 23 23 2 2 2 2 2 2 2 2 2 2 2 2 2 6 13 32 4 5 4 5 4 5 4 5 4 5 
4 5 4 5 4 5 4 5 4 5 32 2 2 2 2 2 2 2 2 2 2 2 2 2 2 6 1 2 2 2 2 2 2 2 2 2 2 2 2 2 6 1 1 1 1 1 1 1 1 13 2 2 2 24 4 5 4 5 4 5 4 22 3 25 26 25 26 26 3 2 6 13 2 2 2 2 2 2 2 2 20 1 1 21 2 12 20 1 13 32 4 5 4 5 4 5 4 5 4 5 
4 5 4 5 4 5 4 5 4 5 32 32 2 12 2 2 2 2 2 2 2 2 2 2 14 1 13 2 2 2 2 2 2 2 2 32 32 32 2 2 6 1 1 1 1 1 1 1 1 13 2 11 2 31 4 5 4 5 4 5 4 22 3 18 19 18 19 19 3 2 6 1 21 23 2 12 2 2 2 2 6 1 1 1 1 1 1 1 13 32 4 5 4 5 4 5 4 5 4 5 
4 5 4 5 4 5 4 5 4 5 32 32 2 2 2 14 2 2 2 2 12 2 2 2 2 1 13 2 2 2 2 2 2 14 2 32 2 32 32 2 2 6 1 28 2 2 2 2 2 2 2 2 24 3 4 5 4 5 4 5 4 22 3 25 26 25 26 26 3 2 6 1 1 1 1 1 1 1 1 1 1 1 1 1 1 1 1 1 28 32 4 5 4 5 4 5 4 5 4 5 
4 5 4 5 4 5 4 5 4 5 32 32 2 2 2 2 2 2 2 2 2 2 2 2 2 6 1 2 2 2 2 2 2 2 2 32 2 14 32 32 2 6 13 2 23 2 2 2 2 2 11 2 24 5 4 5 4 5 4 5 4 22 3 3 3 3 3 3 3 2 27 1 1 1 1 1 1 1 1 1 1 1 1 1 28 2 2 2 2 32 4 5 4 5 4 5 4 5 4 5 
4 5 4 5 4 5 4 5 4 5 32 32 2 12 2 2 2 2 2 2 2 2 2 14 2 6 1 2 2 32 32 32 32 32 32 32 32 32 2 32 2 6 1 2 2 2 2 2 2 2 2 2 24 5 4 5 4 5 4 5 4 22 2 12 2 2 2 2 12 2 2 2 2 2 2 2 2 2 2 27 1 1 1 28 2 2 2 2 32 32 4 5 4 5 4 5 4 5 4 5 
4 5 4 5 4 5 4 5 4 5 32 32 2 2 2 2 2 32 32 32 2 2 2 2 2 6 1 2 2 32 32 32 2 2 2 32 32 32 2 32 2 6 13 2 2 2 2 2 2 2 2 2 24 5 4 5 4 5 4 5 4 29 30 30 30 30 30 30 30 30 30 30 30 30 2 2 2 2 2 2 2 2 2 2 2 2 32 32 32 32 4 5 4 5 4 5 4 5 4 5 
4 5 4 5 4 5 4 5 4 5 32 2 2 2 2 2 32 32 32 32 32 32 32 2 2 6 13 2 2 2 32 32 32 32 32 32 32 2 32 32 2 1 13 2 2 2 2 32 32 32 32 2 24 5 4 5 4 5 4 5 4 3 3 3 3 3 3 3 3 3 3 3 3 3 32 32 32 32 32 32 2 2 2 2 32 32 32 32 32 32 4 5 4 5 4 5 4 5 4 5 
4 5 4 5 4 5 4 5 4 5 32 32 2 2 2 2 32 32 32 23 2 32 32 2 2 6 13 2 2 2 32 32 32 32 32 32 32 32 32 2 2 6 13 2 2 2 32 32 32 32 32 2 24 5 4 5 4 5 4 5 4 5 4 5 4 5 4 5 4 5 4 5 4 5 32 32 32 32 32 32 2 2 2 23 32 32 32 32 32 32 4 5 4 5 4 5 4 5 4 5 
4 5 4 5 4 5 4 5 4 5 32 32 2 2 2 2 2 32 32 32 2 32 32 2 2 6 13 2 2 2 2 2 2 2 2 2 2 2 2 2 20 1 13 2 2 32 32 32 32 32 32 2 2 17 4 5 4 5 4 5 4 5 4 5 4 5 4 5 4 5 4 5 4 5 32 32 32 32 32 32 32 2 2 32 32 32 32 32 32 32 4 5 4 5 4 5 4 5 4 5 
4 5 4 5 4 5 4 5 4 5 32 32 2 2 2 2 32 32 32 2 32 32 2 2 2 6 1 1 1 1 1 1 1 1 1 1 1 1 1 1 1 1 13 2 2 2 32 32 32 32 32 2 2 24 4 5 4 5 4 5 4 5 4 5 4 5 4 5 4 5 4 5 4 5 32 32 32 32 32 32 32 2 2 32 32 32 12 32 32 32 4 5 4 5 4 5 4 5 4 5 
4 5 4 5 4 5 4 5 4 5 32 32 2 2 2 2 32 2 2 32 32 2 23 2 2 27 1 1 1 1 1 1 1 1 1 1 1 1 1 1 1 1 1 2 2 2 2 2 2 2 2 2 2 24 4 5 4 5 4 5 4 5 4 5 4 5 4 5 4 5 4 5 4 5 22 2 2 2 2 2 2 20 1 21 2 2 2 2 2 32 4 5 4 5 4 5 4 5 4 5 
4 5 4 5 4 5 4 5 4 5 32 32 2 2 2 2 32 32 32 32 2 2 2 2 2 2 2 2 2 2 2 2 2 2 2 2 2 2 2 2 27 1 13 2 2 2 2 32 2 2 14 2 2 2 17 5 4 5 4 5 4 5 4 5 4 5 4 5 4 5 4 5 4 5 29 2 2 2 2 2 2 27 1 1 1 1 1 21 2 32 4 5 4 5 4 5 4 5 4 5 
4 5 4 5 4 5 4 5 4 5 32 32 2 2 2 2 2 2 2 2 2 2 2 2 2 2 2 2 2 2 2 2 2 2 2 2 2 2 2 2 2 6 1 2 2 2 2 32 32 2 2 2 2 2 2 16 16 16 16 16 16 16 16 16 17 5 4 5 4 5 4 5 4 5 3 22 2 2 2 2 2 2 2 27 1 1 1 13 2 32 4 5 4 5 4 5 4 5 4 5 
4 5 4 5 4 5 4 5 4 5 32 32 2 2 2 2 2 2 2 2 2 2 2 2 2 2 2 2 2 2 32 32 2 2 2 2 2 2 2 2 2 6 13 2 2 2 14 2 32 32 32 32 32 32 2 2 2 2 32 32 32 32 32 2 2 16 17 5 4 5 4 5 4 5 4 22 2 2 2 2 2 2 2 2 27 1 1 13 2 32 4 5 4 5 4 5 4 5 4 5 
4 5 4 5 4 5 4 5 4 5 32 32 2 2 2 2 2 2 2 2 11 2 2 2 2 2 2 2 32 32 32 2 2 2 2 23 2 2 2 2 2 6 1 2 2 2 2 2 2 2 2 32 32 32 2 2 2 2 32 32 32 32 32 32 2 2 2 5 4 5 4 5 4 5 4 22 2 2 2 2 2 2 2 2 2 2 6 13 2 32 4 5 4 5 4 5 4 5 4 5 
4 5 4 5 4 5 4 5 4 5 32 32 2 2 2 2 21 2 2 2 2 2 2 2 2 2 12 2 32 2 2 2 2 2 2 2 2 2 2 2 2 1 13 2 2 2 2 2 2 2 32 32 2 2 14 2 2 2 32 32 32 32 32 2 2 2 2 17 4 5 4 5 4 5 4 22 2 12 2 2 2 2 2 2 2 2 6 13 2 32 4 5 4 5 4 5 4 5 4 5 
4 5 4 5 4 5 4 5 4 5 32 32 2 2 2 2 2 2 2 2 2 2 23 11 2 2 2 2 32 2 2 2 2 2 2 2 2 2 2 2 2 6 13 2 2 2 2 2 2 2 32 32 2 2 2 2 2 2 2 2 2 2 2 12 2 2 2 24 4 5 4 5 4 5 4 22 2 2 2 2 2 2 2 2 2 2 6 13 2 32 4 5 4 5 4 5 4 5 4 5 
4 5 4 5 4 5 4 5 4 5 32 32 2 2 2 2 2 2 2 2 2 2 2 2 2 2 2 2 32 11 2 2 2 12 2 2 2 2 2 2 2 6 13 2 2 2 2 2 2 2 2 32 32 32 32 32 2 2 2 2 2 2 2 2 2 2 2 24 4 5 4 5 4 5 4 22 2 2 2 2 23 2 2 2 2 2 1 1 2 32 4 5 4 5 4 5 4 5 4 5 
4 5 4 5 4 5 4 5 4 5 32 32 2 2 2 2 2 2 2 2 2 2 2 2 2 2 2 2 32 32 2 2 2 2 2 2 2 2 2 2 2 6 13 2 2 2 2 2 2 2 2 2 2 2 2 2 2 2 2 2 2 2 32 32 32 32 2 24 4 5 4 5 4 5 4 22 2 2 2 2 2 2 2 2 2 2 1 13 2 32 4 5 4 5 4 5 4 5 4 5 
4 5 4 5 4 5 4 5 4 5 32 32 2 2 2 2 32 32 2 2 2 2 2 2 2 2 2 2 2 32 2 2 2 2 2 14 2 2 2 2 2 6 1 21 2 2 2 2 2 2 2 2 2 2 2 2 2 2 2 2 2 2 2 2 2 2 2 24 4 5 4 5 4 5 4 22 2 2 2 2 20 21 2 12 2 23 6 13 2 32 4 5 4 5 4 5 4 5 4 5 
4 5 4 5 4 5 4 5 4 5 32 32 2 2 2 2 32 32 32 2 12 2 2 2 2 2 2 23 2 2 2 2 2 2 2 2 2 2 2 2 2 1 1 1 1 1 1 1 1 1 1 1 1 1 1 1 1 1 1 1 1 1 1 1 21 2 2 24 4 5 4 5 4 5 4 22 2 2 2 2 27 28 2 2 2 2 6 13 2 32 4 5 4 5 4 5 4 5 4 5 
4 5 4 5 4 5 4 5 4 5 32 32 2 2 2 32 32 32 32 2 2 2 2 2 2 10 2 2 2 2 2 2 2 2 2 20 2 2 2 2 2 1 1 1 1 1 1 1 1 1 1 1 1 1 1 1 1 1 1 1 1 1 1 1 13 2 2 24 4 5 4 5 4 5 4 22 2 2 2 2 2 2 2 2 2 2 6 1 2 32 4 5 4 5 4 5 4 5 4 5 
4 5 4 5 4 5 4 5 4 5 32 32 2 2 2 32 32 32 32 2 2 2 2 2 2 2 2 2 2 2 2 2 2 32 32 32 32 32 32 2 2 6 13 2 2 2 2 2 2 2 2 2 2 2 2 2 2 2 2 2 2 2 27 1 13 2 2 24 4 5 4 5 4 5 4 22 2 2 2 2 2 2 2 2 2 20 1 13 2 32 4 5 4 5 4 5 4 5 4 5 
4 5 4 5 4 5 4 5 4 5 32 32 2 2 2 2 32 32 32 2 2 2 2 2 2 2 2 2 2 2 2 2 32 32 32 32 32 32 32 2 2 1 13 2 2 2 2 23 2 2 32 32 32 32 32 2 2 2 2 3 3 3 3 1 3 3 3 24 4 5 4 5 4 5 4 22 2 2 2 2 2 2 20 1 1 1 1 1 2 32 4 5 4 5 4 5 4 5 4 5 
4 5 4 5 4 5 4 5 4 5 32 32 2 2 2 2 2 2 28 2 2 2 2 2 2 2 2 2 2 2 2 2 32 32 32 32 32 32 32 2 2 1 13 2 2 32 2 2 2 2 32 32 32 32 32 2 2 2 2 3 18 19 18 19 18 19 3 3 17 5 4 5 4 5 4 22 2 12 2 2 2 2 1 1 1 1 1 28 2 32 4 5 4 5 4 5 4 5 4 5 
4 5 4 5 4 5 4 5 4 5 32 32 2 2 2 2 2 2 2 2 2 23 2 2 2 2 2 12 2 2 2 2 32 32 32 32 32 32 32 2 2 6 1 2 32 32 2 2 20 21 32 32 32 14 32 32 2 2 2 3 25 26 25 26 25 26 26 3 24 5 4 5 4 5 4 22 2 2 2 2 2 2 6 1 2 2 2 2 2 32 4 5 4 5 4 5 4 5 4 5 
4 5 4 5 4 5 4 5 4 5 32 32 2 2 2 2 2 2 2 2 2 2 2 2 2 2 2 2 2 2 2 2 32 32 32 32 32 32 32 2 2 6 1 2 32 2 32 2 27 28 32 32 32 32 32 32 32 32 2 3 18 19 18 19 18 19 19 3 24 5 4 5 4 5 4 22 2 2 2 2 2 2 6 13 23 2 2 2 2 32 4 5 4 5 4 5 4 5 4 5 
4 5 4 5 4 5 4 5 4 5 32 3 3 3 3 3 3 3 3 2 2 2 2 2 2 2 2 2 2 2 2 2 2 32 32 2 2 2 2 2 2 6 1 2 2 32 32 2 2 2 32 32 32 32 32 32 32 32 2 3 25 26 25 26 25 26 26 3 24 5 4 5 4 5 4 22 2 2 2 2 2 2 6 13 2 2 2 2 2 32 4 5 4 5 4 5 4 5 4 5 
4 5 4 5 4 5 4 5 4 5 32 3 18 19 18 19 18 19 3 2 2 2 2 12 2 2 2 2 2 2 2 2 2 2 2 2 2 2 2 2 2 1 13 2 2 2 2 2 2 23 2 32 32 32 32 32 32 32 2 3 18 18 18 19 18 19 19 3 24 5 4 5 4 5 4 22 2 2 2 2 2 2 6 13 2 2 12 2 2 32 4 5 4 5 4 5 4 5 4 5 
4 5 4 5 4 5 4 5 4 5 32 3 25 26 25 26 25 26 3 2 2 2 2 2 2 2 2 2 2 2 2 2 2 2 2 2 2 2 2 2 2 1 13 2 2 2 2 2 2 2 2 32 32 32 32 32 32 2 2 3 3 26 25 26 25 26 26 3 24 5 4 5 4 5 4 22 2 2 2 23 2 2 1 13 2 2 2 2 32 32 4 5 4 5 4 5 4 5 4 5 
4 5 4 5 4 5 4 5 4 5 32 3 18 19 18 19 18 18 3 2 2 2 2 2 2 2 2 2 2 2 2 2 2 2 2 2 2 2 2 2 20 1 1 21 2 2 2 2 2 2 2 2 2 32 32 32 32 32 2 2 3 3 3 3 3 3 3 3 24 5 4 5 4 5 4 22 23 2 2 2 23 23 6 13 2 2 2 2 32 32 4 5 4 5 4 5 4 5 4 5 
4 5 4 5 4 5 4 5 4 5 32 3 25 26 25 26 25 25 1 1 1 1 1 1 1 1 1 1 1 1 1 1 1 1 1 1 1 1 1 1 1 1 1 1 1 1 1 1 1 13 2 2 2 2 2 2 32 32 2 2 32 32 32 32 32 32 32 32 24 5 4 5 4 5 4 22 2 32 32 32 2 2 1 13 2 2 2 32 32 32 4 5 4 5 4 5 4 5 4 5 
4 5 4 5 4 5 4 5 4 5 32 3 18 19 18 19 18 18 3 27 1 1 1 1 1 1 1 1 1 1 1 1 1 1 1 1 1 1 1 1 1 1 1 1 1 1 1 1 1 13 2 2 2 2 2 2 2 32 32 32 32 32 32 32 32 32 32 32 24 5 4 5 4 5 4 22 2 32 32 32 2 2 1 13 2 2 2 32 32 32 4 5 4 5 4 5 4 5 4 5 
4 5 4 5 4 5 4 5 4 5 32 3 25 26 25 26 25 25 3 2 2 2 2 2 2 2 2 2 2 2 2 2 2 2 2 2 2 2 2 23 2 2 2 2 2 2 2 2 6 13 2 2 32 32 32 32 32 32 32 32 32 32 32 32 32 32 32 32 24 5 4 5 4 5 4 22 2 2 32 32 2 2 6 1 2 2 2 2 32 32 4 5 4 5 4 5 4 5 4 5 
4 5 4 5 4 5 4 5 4 5 32 3 18 19 18 19 25 26 3 3 3 2 2 2 2 2 2 2 2 2 2 2 2 2 2 2 2 2 2 2 2 2 2 2 2 2 2 2 6 13 2 2 32 32 32 32 32 32 32 32 2 30 30 30 30 30 30 30 31 5 4 5 4 5 4 22 2 2 2 2 2 2 6 1 2 2 2 2 32 32 4 5 4 5 4 5 4 5 4 5 
4 5 4 5 4 5 4 5 4 5 32 3 25 26 25 26 18 19 18 19 3 2 2 2 2 2 2 2 32 32 32 2 2 2 2 2 2 2 2 2 2 2 2 2 2 2 2 2 6 1 2 2 2 2 2 32 32 32 2 2 31 3 3 3 3 3 3 3 3 5 4 5 4 5 4 22 2 2 2 2 2 2 1 1 1 13 2 2 32 32 4 5 4 5 4 5 4 5 4 5 
4 5 4 5 4 5 4 5 4 5 32 3 18 19 18 19 25 26 25 26 3 2 2 2 2 2 2 2 32 32 32 2 2 23 2 2 2 32 32 32 32 2 2 2 23 2 2 2 1 1 2 2 12 2 2 2 32 32 2 24 3 5 4 5 4 5 4 5 4 5 4 5 4 5 4 22 2 2 2 2 2 2 27 1 1 13 2 2 32 32 4 5 4 5 4 5 4 5 4 5 
4 5 4 5 4 5 4 5 4 5 32 3 25 26 25 26 18 19 18 19 3 32 32 2 2 2 32 32 2 32 2 2 2 2 2 2 2 2 2 2 32 32 32 2 2 2 2 2 6 1 2 2 2 2 2 2 2 2 2 24 4 5 4 5 4 5 4 5 4 5 4 5 4 5 4 22 2 2 2 2 2 2 2 2 6 13 2 2 32 32 4 5 4 5 4 5 4 5 4 5 
4 5 4 5 4 5 4 5 4 5 32 3 18 19 18 19 25 26 25 26 3 32 32 2 23 2 2 32 32 32 2 2 2 2 2 2 2 2 2 2 2 2 32 32 2 2 2 2 6 1 2 2 2 2 2 2 2 2 2 24 4 5 4 5 4 5 4 5 4 5 15 16 16 16 16 2 2 32 2 2 2 2 2 2 6 1 2 2 2 32 4 5 4 5 4 5 4 5 4 5 
4 5 4 5 4 5 4 5 4 5 32 3 25 26 25 26 25 26 25 26 3 32 32 32 32 2 6 32 32 2 2 2 2 2 2 2 2 14 2 2 2 2 2 2 2 2 2 2 6 13 2 2 2 2 2 2 2 2 2 24 4 5 4 5 4 5 4 5 4 5 22 2 2 2 2 2 2 2 2 2 2 2 2 2 6 1 2 2 2 32 4 5 4 5 4 5 4 5 4 5 
4 5 4 5 4 5 4 5 4 5 32 3 3 3 3 3 3 3 3 3 3 32 32 32 2 2 2 2 2 2 2 20 1 1 1 1 1 1 1 1 1 1 1 1 21 2 2 2 6 13 2 2 2 2 2 2 2 2 2 24 4 5 4 5 4 5 4 5 4 5 22 2 2 12 2 2 2 2 2 32 2 2 2 2 6 13 2 2 2 32 4 5 4 5 4 5 4 5 4 5 
4 5 4 5 4 5 4 5 4 5 32 32 32 32 32 32 32 32 32 32 32 32 32 32 2 14 2 2 2 2 2 6 1 1 1 1 1 1 1 1 1 1 1 1 13 2 2 2 1 13 2 2 2 2 2 2 2 2 2 24 4 5 4 5 4 5 4 5 4 15 2 2 2 2 2 2 2 2 2 2 2 2 2 2 6 13 2 2 2 32 4 5 4 5 4 5 4 5 4 5 
4 5 4 5 4 5 4 5 4 5 32 32 2 2 2 2 32 32 2 2 2 2 2 2 2 2 2 32 32 32 2 6 1 1 1 1 1 1 1 1 1 1 1 1 13 2 2 20 1 1 2 2 2 2 2 2 2 2 2 24 4 5 4 5 4 5 4 5 4 22 2 2 12 2 2 32 2 2 2 2 2 2 23 2 1 1 2 2 2 32 4 5 4 5 4 5 4 5 4 5 
4 5 4 5 4 5 4 5 4 5 32 32 2 32 32 2 2 32 32 2 2 2 2 32 32 32 32 2 2 2 2 6 1 1 1 1 1 1 1 1 1 1 1 1 1 1 1 1 1 13 2 2 2 2 2 2 2 2 2 24 4 5 4 5 4 5 4 5 4 22 2 2 2 2 2 2 2 2 2 12 2 2 2 20 1 1 2 2 2 32 4 5 4 5 4 5 4 5 4 5 
4 5 4 5 4 5 4 5 4 5 32 32 2 32 32 32 32 2 32 2 2 2 32 32 2 2 2 2 2 2 2 6 1 1 1 1 1 1 1 1 1 1 1 1 1 1 1 1 1 28 2 2 2 2 2 2 2 2 2 24 4 5 4 5 4 5 4 5 4 22 2 2 2 2 2 2 2 20 1 1 1 1 1 1 1 1 21 2 2 32 4 5 4 5 4 5 4 5 4 5 
4 5 4 5 4 5 4 5 4 5 32 32 2 32 2 32 32 32 32 2 23 2 2 2 2 2 2 2 2 2 2 6 1 1 1 1 1 1 1 1 1 1 1 1 13 2 2 2 2 2 2 2 2 2 2 2 14 2 2 24 4 5 4 5 4 5 4 5 4 22 2 32 32 32 2 2 2 6 1 1 1 1 1 1 1 1 13 2 2 32 4 5 4 5 4 5 4 5 4 5 
4 5 4 5 4 5 4 5 4 5 32 32 2 32 2 2 2 2 2 2 2 2 2 20 1 1 1 1 1 1 1 1 1 1 1 1 1 1 1 1 1 1 1 1 13 2 2 2 2 2 2 2 2 2 2 2 2 2 2 24 4 5 4 5 4 5 4 5 4 22 2 32 32 32 2 32 2 6 1 1 1 1 1 1 1 1 13 2 2 32 4 5 4 5 4 5 4 5 4 5 
4 5 4 5 4 5 4 5 4 5 32 32 2 2 2 2 2 2 2 2 2 2 2 6 1 1 1 1 1 1 1 1 1 1 1 1 1 1 1 1 1 1 1 1 13 2 2 2 2 2 2 2 2 2 2 2 2 2 2 24 4 5 4 5 4 5 4 5 4 22 32 32 32 32 32 32 2 6 1 1 1 1 1 1 1 1 13 2 2 32 4 5 4 5 4 5 4 5 4 5 
4 5 4 5 4 5 4 5 4 5 32 32 2 2 2 2 2 2 2 2 2 2 2 6 1 28 2 2 2 23 2 6 1 1 1 1 1 1 1 1 1 1 1 1 13 2 2 2 2 2 2 2 2 2 20 21 2 2 2 24 4 5 4 5 4 5 4 5 4 22 32 32 32 32 32 2 2 6 1 1 1 1 1 1 1 1 13 2 12 32 4 5 4 5 4 5 4 5 4 5 
4 5 4 5 4 5 4 5 4 5 32 32 32 32 32 2 2 2 14 2 2 2 2 6 13 2 14 2 2 2 2 6 1 1 1 1 1 1 1 1 1 1 1 1 13 2 2 2 2 2 12 2 2 2 27 28 2 2 2 24 4 5 4 5 4 5 4 5 4 22 32 32 32 32 2 23 2 6 1 1 1 1 1 1 1 1 13 2 2 32 4 5 4 5 4 5 4 5 4 5 
4 5 4 5 4 5 4 5 4 5 32 32 32 32 32 2 2 2 2 2 2 2 2 6 13 2 2 2 2 2 2 6 1 1 1 1 1 1 1 1 1 1 1 1 13 2 2 2 2 2 2 2 2 2 2 2 2 2 2 24 4 5 4 5 4 5 4 5 4 22 2 2 2 2 2 2 2 6 1 1 1 1 1 1 1 1 13 2 2 32 4 5 4 5 4 5 4 5 4 5 
4 5 4 5 4 5 4 5 4 5 32 32 32 32 32 2 2 2 2 2 2 2 2 6 13 2 2 2 2 2 2 6 1 1 1 1 1 1 1 1 1 1 1 1 13 2 2 2 2 2 2 2 2 2 2 2 2 2 2 24 4 5 4 5 4 5 4 5 4 22 2 2 2 2 2 2 2 27 1 1 1 1 1 1 1 1 28 2 32 32 4 5 4 5 4 5 4 5 4 5 
4 5 4 5 4 5 4 5 4 5 32 32 32 32 32 2 2 2 2 2 2 2 2 6 13 2 2 23 2 2 2 6 1 1 1 1 1 1 1 1 1 1 1 1 13 2 2 2 2 2 2 2 2 2 14 2 2 2 2 24 4 5 4 5 4 5 4 5 4 22 2 2 2 2 2 2 2 2 2 27 1 1 28 2 2 2 2 2 32 32 4 5 4 5 4 5 4 5 4 5 
4 5 4 5 4 5 4 5 4 5 32 32 32 32 32 2 2 2 2 2 2 2 2 6 13 2 2 2 2 14 2 27 1 1 1 1 1 1 1 1 1 1 1 1 28 23 2 2 2 2 2 2 2 2 2 2 2 2 2 24 4 5 4 5 4 5 4 5 4 22 2 2 2 2 2 2 2 2 2 2 6 13 2 2 2 13 32 32 32 32 4 5 4 5 4 5 4 5 4 5 
4 5 4 5 4 5 4 5 4 5 32 32 32 2 2 2 2 2 2 2 2 2 2 6 13 2 2 2 2 2 2 2 2 2 2 2 2 2 27 1 1 28 2 2 2 2 2 2 2 2 2 2 2 2 2 2 2 2 2 24 4 5 4 5 4 5 15 16 16 2 2 2 2 14 2 2 2 2 2 2 6 13 2 2 2 2 32 32 32 32 4 5 4 5 4 5 4 5 4 5 
4 5 4 5 4 5 4 5 4 5 32 32 32 14 2 2 2 2 2 2 2 2 2 6 13 2 2 14 2 2 2 2 2 2 2 2 2 2 2 6 13 2 2 2 2 2 2 2 2 2 2 2 2 2 2 2 2 2 2 24 4 5 4 5 4 5 22 2 2 2 2 2 2 2 2 2 2 2 2 2 6 13 2 2 14 2 2 32 32 32 4 5 4 5 4 5 4 5 4 5 
4 5 4 5 4 5 4 5 4 5 32 32 32 2 2 2 2 2 2 2 2 2 20 1 13 2 2 2 2 2 2 2 2 2 2 2 2 2 2 6 13 2 2 2 2 2 2 2 2 14 2 2 2 2 2 2 2 2 2 24 4 5 4 5 4 5 22 2 2 2 2 2 2 2 2 2 2 2 2 2 6 13 23 2 2 2 2 2 2 32 4 5 4 5 4 5 4 5 4 5 
4 5 4 5 4 5 4 5 4 5 32 32 2 2 20 1 1 1 1 1 1 1 1 1 13 2 2 2 2 2 2 2 2 2 2 2 2 2 2 1 13 2 2 2 2 2 2 2 2 2 2 2 2 2 2 2 2 2 2 24 4 5 4 5 4 5 22 2 2 2 2 2 2 6 2 2 2 2 2 2 6 1 2 2 2 2 2 12 2 32 4 5 4 5 4 5 4 5 4 5 
4 5 4 5 4 5 4 5 4 5 32 32 2 2 6 1 1 1 1 1 1 1 1 1 28 2 2 2 20 21 2 2 2 2 2 2 2 2 2 1 13 2 2 2 2 2 2 2 2 2 2 2 2 2 2 2 2 2 2 24 4 5 4 5 4 5 22 2 2 12 2 2 2 2 2 2 2 2 14 2 1 13 2 2 2 2 2 2 2 32 4 5 4 5 4 5 4 5 4 5 
4 5 4 5 4 5 4 5 4 5 32 32 32 2 6 13 23 2 2 2 2 2 2 2 2 2 2 2 27 28 2 2 2 2 2 2 2 2 2 6 1 2 2 2 2 2 2 2 2 2 2 2 2 2 2 2 2 2 2 24 4 5 4 5 4 5 22 2 2 2 2 2 2 23 2 2 2 2 2 2 6 13 2 2 2 2 2 2 2 32 4 5 4 5 4 5 4 5 4 5 
4 5 4 5 4 5 4 5 4 5 32 32 32 2 6 13 2 14 2 2 2 2 2 2 2 2 2 2 6 2 2 2 2 2 2 2 2 2 2 6 13 2 2 2 2 2 2 2 2 2 2 2 32 32 32 32 32 32 32 24 4 5 4 5 4 5 22 2 2 2 2 2 2 2 2 2 2 2 2 20 1 1 2 2 2 2 2 2 2 32 4 5 4 5 4 5 4 5 4 5 
4 5 4 5 4 5 4 5 4 5 29 30 30 30 6 13 30 30 30 31 32 2 2 2 2 2 2 2 2 2 2 2 2 2 2 13 2 2 2 1 13 2 2 2 2 2 2 32 32 32 32 32 32 32 32 32 32 32 32 24 4 5 4 5 4 5 22 32 32 32 32 2 20 1 1 1 1 1 1 1 1 1 2 2 2 32 32 32 32 32 4 5 4 5 4 5 4 5 4 5 
4 5 4 5 4 5 4 5 4 5 3 3 3 3 27 28 3 3 3 3 32 2 2 12 2 2 2 2 32 32 32 32 2 2 2 2 2 2 2 6 1 21 2 2 2 2 2 2 2 2 32 32 32 32 32 2 2 32 32 24 4 5 4 5 4 5 22 32 32 32 32 2 1 1 1 1 1 1 1 1 1 13 23 2 2 32 32 32 32 32 4 5 4 5 4 5 4 5 4 5 
4 5 4 5 4 5 4 5 4 5 4 5 5 5 5 4 4 5 5 5 32 2 2 2 2 2 2 32 32 32 2 32 2 2 2 2 2 2 2 6 1 1 1 1 1 1 1 1 1 21 32 32 32 32 32 2 14 32 32 32 17 5 4 5 4 5 22 32 32 32 2 2 6 1 28 2 2 2 2 2 2 2 2 2 32 32 32 32 32 32 4 5 4 5 4 5 4 5 4 5 
4 5 4 5 4 5 4 5 4 5 4 5 5 5 4 4 4 5 4 5 32 32 2 2 2 2 2 32 32 32 32 32 2 2 2 2 2 2 2 27 1 1 1 1 1 1 1 1 1 13 32 32 32 32 32 2 32 32 32 32 24 5 4 5 4 5 22 2 2 2 2 2 1 1 2 32 2 2 2 2 2 2 2 2 2 2 32 32 32 32 4 5 4 5 4 5 4 5 4 5 
4 5 4 5 4 5 4 5 4 5 4 5 4 5 4 4 4 4 5 5 32 32 32 2 14 2 2 32 32 32 32 32 2 2 2 2 2 2 2 2 2 2 2 2 2 32 2 27 1 13 32 32 32 32 32 32 32 32 32 32 24 5 4 5 4 5 22 2 2 2 32 2 27 28 2 2 2 2 2 2 2 20 21 2 2 2 2 2 2 32 4 5 4 5 4 5 4 5 4 5 
4 5 4 5 4 5 4 5 4 5 4 5 4 5 4 5 5 4 5 5 32 32 32 2 2 2 6 32 32 2 32 32 2 2 2 2 2 2 2 2 2 2 2 2 2 32 2 32 6 13 32 32 32 32 32 32 32 32 32 32 24 5 4 5 4 5 22 2 2 2 2 30 8 9 30 2 2 2 2 2 2 27 28 2 2 2 2 12 2 32 4 5 4 5 4 5 4 5 4 5 
4 5 4 5 4 5 4 5 4 5 4 5 4 5 4 5 5 4 5 5 32 32 12 2 2 2 2 32 32 32 32 2 2 2 14 2 2 2 2 2 2 2 32 32 2 32 32 32 6 1 32 32 32 32 32 32 32 32 32 32 24 5 4 5 4 5 29 30 30 30 31 3 8 9 3 29 2 12 2 2 2 2 2 2 2 2 2 2 2 32 4 5 4 5 4 5 4 5 4 5 
4 5 4 5 4 5 4 5 4 5 4 5 4 4 5 4 5 4 5 5 32 32 32 32 32 2 2 2 2 2 2 2 2 2 2 2 2 2 2 2 2 2 32 32 32 32 32 32 6 13 32 32 32 32 32 32 32 32 32 32 24 5 4 5 4 5 3 3 3 3 3 5 8 9 4 3 2 2 2 2 2 2 2 2 2 2 2 2 2 32 4 5 4 5 4 5 4 5 4 5 
4 5 4 5 4 5 4 5 4 5 4 5 4 4 5 4 5 4 5 5 32 32 32 32 2 2 2 2 2 2 2 2 2 2 2 2 32 32 2 2 2 2 32 32 32 32 32 32 6 13 32 32 32 32 32 32 32 32 32 32 24 5 4 5 4 5 4 5 4 5 4 5 8 9 4 5 29 30 30 30 30 30 30 30 30 30 30 30 30 31 4 5 4 5 4 5 4 5 4 5 
4 5 4 5 4 5 4 5 4 5 4 5 4 4 5 4 5 5 5 5 32 2 2 12 2 2 2 2 2 2 2 2 2 2 32 32 32 32 32 2 14 2 2 32 32 32 32 32 6 1 1 1 1 1 1 13 2 2 2 2 24 5 4 5 4 5 4 5 4 5 4 5 8 9 4 5 3 3 3 3 3 3 3 3 3 3 3 3 3 3 4 5 4 5 4 5 4 5 4 5 
4 5 4 5 4 5 4 5 4 5 4 5 4 4 5 4 5 5 4 5 32 32 32 32 32 2 2 2 2 2 2 2 32 32 32 32 32 32 32 2 2 2 32 32 32 32 2 32 1 1 1 1 1 1 1 1 1 1 1 21 18 19 18 19 18 19 18 19 18 19 18 19 18 19 4 5 4 5 4 5 4 5 4 5 4 5 4 5 4 5 4 5 4 5 4 5 4 5 4 5 
4 5 4 5 4 5 4 5 4 5 4 5 4 4 5 5 5 5 4 5 32 2 14 2 2 2 2 2 2 2 2 2 32 32 32 32 32 32 32 2 2 32 32 32 32 32 32 32 32 32 32 32 32 32 6 1 1 1 1 28 25 26 25 26 25 26 25 26 25 26 25 26 25 26 4 5 4 5 4 5 4 5 4 5 4 5 4 5 4 5 4 5 4 5 4 5 4 5 4 5 
4 5 4 5 4 5 4 5 4 5 4 4 4 4 4 4 4 5 4 5 32 2 2 2 2 2 2 2 2 2 2 2 2 2 2 2 2 2 2 2 2 32 32 2 2 2 32 32 32 32 32 32 32 32 32 32 32 32 32 32 24 5 4 5 4 5 4 5 4 5 4 5 4 5 4 5 4 5 4 5 4 5 4 5 4 5 4 5 4 5 4 5 4 5 4 5 4 5 4 5 
4 5 4 5 4 5 4 5 4 5 4 4 4 4 4 4 4 4 4 5 29 30 30 30 30 30 30 30 30 30 30 30 30 30 30 30 30 30 30 30 30 30 30 30 30 30 30 30 30 30 30 30 30 30 30 30 30 30 30 30 31 5 4 5 4 5 4 5 4 5 4 5 4 5 4 5 4 5 4 5 4 5 4 5 4 5 4 5 4 5 4 5 4 5 4 5 4 5 4 5 
4 5 4 5 4 5 4 5 4 5 4 5 4 5 4 5 4 5 4 5 4 5 4 5 4 5 4 5 4 5 4 5 4 5 4 5 4 5 4 5 4 5 4 5 4 5 4 5 4 5 4 5 4 5 4 5 4 5 4 5 4 5 4 5 4 5 4 5 4 5 4 5 4 5 4 5 4 5 4 5 4 5 4 5 4 5 4 5 4 5 4 5 4 5 4 5 4 5 4 5 
4 5 4 5 4 5 4 5 4 5 4 5 4 5 4 5 4 5 4 5 4 5 4 5 4 5 4 5 4 5 4 5 4 5 4 5 4 5 4 5 4 5 4 5 4 5 4 5 4 5 4 5 4 5 4 5 4 5 4 5 4 5 4 5 4 5 4 5 4 5 4 5 4 5 4 5 4 5 4 5 4 5 4 5 4 5 4 5 4 5 4 5 4 5 4 5 4 5 4 5 
4 5 4 5 4 5 4 5 4 5 4 5 4 5 4 5 4 5 4 5 4 5 4 5 4 5 4 5 4 5 4 5 4 5 4 5 4 5 4 5 4 5 4 5 4 5 4 5 4 5 4 5 4 5 4 5 4 5 4 5 4 5 4 5 4 5 4 5 4 5 4 5 4 5 4 5 4 5 4 5 4 5 4 5 4 5 4 5 4 5 4 5 4 5 4 5 4 5 4 5 
4 5 4 5 4 5 4 5 4 5 4 5 4 5 4 5 4 5 4 5 4 5 4 5 4 5 4 5 4 5 4 5 4 5 4 5 4 5 4 5 4 5 4 5 4 5 4 5 4 5 4 5 4 5 4 5 4 5 4 5 4 5 4 5 4 5 4 5 4 5 4 5 4 5 4 5 4 5 4 5 4 5 4 5 4 5 4 5 4 5 4 5 4 5 4 5 4 5 4 5 
4 5 4 5 4 5 4 5 4 5 4 5 4 5 4 5 4 5 4 5 4 5 4 5 4 5 4 5 4 5 4 5 4 5 4 5 4 5 4 5 4 5 4 5 4 5 4 5 4 5 4 5 4 5 4 5 4 5 4 5 4 5 4 5 4 5 4 5 4 5 4 5 4 5 4 5 4 5 4 5 4 5 4 5 4 5 4 5 4 5 4 5 4 5 4 5 4 5 4 5 
4 5 4 5 4 5 4 5 4 5 4 5 4 5 4 5 4 5 4 5 4 5 4 5 4 5 4 5 4 5 4 5 4 5 4 5 4 5 4 5 4 5 4 5 4 5 4 5 4 5 4 5 4 5 4 5 4 5 4 5 4 5 4 5 4 5 4 5 4 5 4 5 4 5 4 5 4 5 4 5 4 5 4 5 4 5 4 5 4 5 4 5 4 5 4 5 4 5 4 5 
4 5 4 5 4 5 4 5 4 5 4 5 4 5 4 5 4 5 4 5 4 5 4 5 4 5 4 5 4 5 4 5 4 5 4 5 4 5 4 5 4 5 4 5 4 5 4 5 4 5 4 5 4 5 4 5 4 5 4 5 4 5 4 5 4 5 4 5 4 5 4 5 4 5 4 5 4 5 4 5 4 5 4 5 4 5 4 5 4 5 4 5 4 5 4 5 4 5 4 5 
4 5 4 5 4 5 4 5 4 5 4 5 4 5 4 5 4 5 4 5 4 5 4 5 4 5 4 5 4 5 4 5 4 5 4 5 4 5 4 5 4 5 4 5 4 5 4 5 4 5 4 5 4 5 4 5 4 5 4 5 4 5 4 5 4 5 4 5 4 5 4 5 4 5 4 5 4 5 4 5 4 5 4 5 4 5 4 5 4 5 4 5 4 5 4 5 4 5 4 5 
4 5 4 5 4 5 4 5 4 5 4 5 4 5 4 5 4 5 4 5 4 5 4 5 4 5 4 5 4 5 4 5 4 5 4 5 4 5 4 5 4 5 4 5 4 5 4 5 4 5 4 5 4 5 4 5 4 5 4 5 4 5 4 5 4 5 4 5 4 5 4 5 4 5 4 5 4 5 4 5 4 5 4 5 4 5 4 5 4 5 4 5 4 5 4 5 4 5 4 5 
4 5 4 5 4 5 4 5 4 5 4 5 4 5 4 5 4 5 4 5 4 5 4 5 4 5 4 5 4 5 4 5 4 5 4 5 4 5 4 5 4 5 4 5 4 5 4 5 4 5 4 5 4 5 4 5 4 5 4 5 4 5 4 5 4 5 4 5 4 5 4 5 4 5 4 5 4 5 4 5 4 5 4 5 4 5 4 5 4 5 4 5 4 5 4 5 4 5 4 5
